0044444444440044444444440044440011111100111111004444
0044444444440044444444440044440011111100111111004444
4444001111110011111100444400444444444400444444444400
4444001111110011111100444400444444444400444444444400
4444001100110011001100444455000000000055000000000055
4444001100110011001100444455000000000055000000000055
4444001111110011001100444455000000000055000000000055
4444001111110011001100444455000000000055000000000055
44440000001100110011004444550000000000550000000000554444000000110011001100444455000000000055000000000055
4444000000110011001100444455000000000055000000000055
4444001111110011111100444455000000000055000000000055
44440011111100111111004444550000000000550000000000554444001111110011111100444455000000000055000000000055
4444444444444444444444444444444444444444444444444444
4444444444444444444444444444444444444444444444444444
5500000000005500000000005544444444444444444444444444
5500000000115511000000005544444444444444444444444444
2200000000111111000000002222000000001111110000000022
220000000011111100000000222200000000111111000000002222000000001111110000000022
2211551155111111551155112222115511551111115511551122
2211551155111111551155112222115511551111115511551122
2211001100110011001100112222115511551111115511551122
2211001100000000001100112222115511551111115511551122
221100110000000000110011222211551155111111551155112222115511551111115511551122
2211001100011110001100112222115511551111115511551122
2222220000013010000022220022115511551111115511551122
2222220000010010000022220022115511551111115511551122